11111111
110C0111
10011111
110P00C1
1E100001
11111111
