11111111
110C0111
10011111
100P00C1
1E100001
11111111
