111111111
1E00000C1
100000011
111000111
1P1110011
10000C111
111111111
