

1111111
1P00CE1
1000111
1111111
